11111111111111111111111111111111111
10000000000J00000000000J0000000J001
100000J00000000000J0000000000000001
100J0000000J00000000000J00009000001
11111111111100000000000111111111111
11111111111100J000J000J111111111111
22222222222223223222322222222222222
2333J333333333333333333J33333333332
2J222222222222223332222222222222232
2333333333333J33333333J3333333322J2
23222222322222222232222222232322232
2333J3323333333J333333333J33233J332
23232222322222222322222222222322232
232333333J3332222333333333J33322232
23222223222222222222232222222222232
23333333233333J33333333333333322232
23222222232222222222222222222333232
23333333J32222222233333332222P2J332
22222222222222222222222222222222222
