11111111111111111111111111111111111
1111111111110J00J000000000000000091
111111111111000J00J0001111111111111
111111111111J00000000J1111111111111
11111111111100J00J00001111111111111
111111111111000J000J001111111111111
22222222222222222222232222222222222
2333333333J333333J33333333333333332
23222222222222223332222222222222232
2333J33333J3333333333333333333322J2
23222222322222222232222222232322232
2J33333233333J333333333J33332333332
23232222322222222322222222222322232
232333333333322223333333J3333322232
232222232222222222222322222222222J2
23J33333233333333J33333333333J22232
23222222232222222222222222222333232
233J33333P2222222233333332222333332
22222222222222222222222222222222222
